###########
#   @    .#
######    #
#    #  $ #
#  #  #   #
#    ##   #
#  $   #  #
#         #
#######   #
#     .   # 
###########