#############
#           #
#           #
#  ###      #
#  .        #
#    ###$   #
#      $    #
#    ###### # 
#    .      #
#        @  # 
#############