###########
#.   ###  #
#   $  ## #
#     .#  #
#    ######
#      #. #
###$#     #
# @ #     #
#####  $  #
#         # 
###########