###########
#        .#
#   $     #
##### #   #
#     $   #
# $ ##### #
#      .  #
#         #
####     .#
# @       # 
###########