#############
#           #
#  $        #
#           #
#           #
#  ###      #
#      $    #
##  ### ##  #
#   #       #
#   ##      #
#    #.#    #  
#    #.#    #
#           #
#          @# 
#############