###########
#         #
#  #####  #
#  #      #
#  # @    #
# $# ##   #
#  #.#    #
#  ###    #
#    $    #
#       . # 
###########