###########
#         #
#  # ###  #
#  #  $   #
#  # @    #
# $# ##   #
#  #.#   .#
#   ##    #
#    $    #
#       . # 
###########