############
#.         #
#          #
##  #      #
#   #      #
#   #@     #
#   #####  #
#     $    #
#          #
#          #
#          #
############
