############
#         .#
#  $  #    #
#     #    #
#######    #
#          #
#    #######
#          #
#######    #
#          #
# @        #
############
