############
#         .#
#  $  #$   #
#     #    #
#######.   #
#          #
#    #######
#          #
#######    #
#          #
# @        #
############
