############
#         .#
#  $  #$   #
#     #    #
#######.   #
#          #
#    #######
#    .     #
#######  $ #
#          #
# @        #
############
