############
#.         #
#          #
##  #      #
#   #      #
# . #@     #
#   #####  #
#.  $   $  #
#     $    #
#          #
#          #
############
