#################
#               #
#               #
#               #
#               #
#               #
#     $$$       #
#               #
#       @       #
#               #
#               #
#               #
#               #
##  #           #
#    #          #
#... #          #
#################