#############
#  #      . #
#  #        #
#   #####  ##
#           #
#  $        #
#           #
#           #
#@    # $   #
#       #   #
#       .   #
#           #
#############