##############
#        #  .#
#          # #
#            #
#            #
#            #
#         #  #
#       $$$@ #
#            #
#        #   #
#            #
# #        ###
#.#         .#
##############