#############
#        # .#
#           #
#      #    #	   
#       #   #
#        #  #
#.        # #
#           #
#           #
### #   $   #
# $ #       #
#   #     @ #
#############