################
#        #     #
#        #     #
#        #     #
#       .#  $  #
#        #     #
#        #     #
# ## ##### @   #
#              #
#              #
#  $      ######
#      #       #
#      #.      #
#      #       #
#      #       #
################