##############
#            #
#            #
# #  ##      #
#  .  #      #
###.# #      #
#  ##        #
#            #
#          @ #
#            #
#            #
# $     $    #
#            #	     
##############