#############
#.          #
## ####### ##
#           #
# $         #
#       .   #
# ########  #
#           #
#  $     $  #
#           #
## #######@##
#          .#
#############