###############
#             #
#           $ #
#   #    #    #
#    #  . #   #
#     #	   #  #
#      #    # #
#          @  #
#             #
#             #
# $    #  #   #
#     # .  #  #
#      #  #   #
#             #
###############