#############
#           #
# #.   # $  #
#       .#  #
#  ###      #
#  $        #
#  $        #
#          @#
#           #
#  #        #
# #.#    $  #
#           #
#############