###############
#             #
#    #   $    #
#             #
#  .   #      #
## #          #
#      $      #
##  #  #   @  #
# .           #
#     #       #
#      #    # #
#        .    #
#  $   #      #
#             #
###############