#################
#               #
#      $        #
#               #
#               #
#               #
#               #
# $             #
#               #
#               #
#               #
#               #
# #  #	@ #     #
#  #  ##   #    #
####   #   ######
# .     #      .#
#################