#############
#           #
#        .  #
#           #
#           #
#           #
#           #
##  #       #
# $$#       #
#   #       #
#      @    #
#.          #
#############