################
#              #
#              #
#              #
#       $      #
#  $           #
#              #
#       $  @   #
#####  #########
#        .     #
# .            #
#              #
#              #
#      .       #
#              #
################