############
#          #
#  *       #
#  @       #
#          #
#      !   #
#          #
############