############
#          #
#      #@  #  
#  @   # * # 
#    #######    
#      !   #
#!         #
############