##########
#        #
#        #
#     #@ #  
#     # *# 
#   ######    
#   ! #### 
#     #### 
##########