#########
#       #
#       #
#       #
#    #@ #  
#    # *# 
#  ######    
#   !####  
#########