#########
#*  @  !#
# @     #
#    !  #
#########