###########
####  ##  #
####      #
##### ##  #
##    #   #
##        #
###$#. #  #
###@###   #
# $$###.. #
#       ###
###########