############
#          #
#      #   #  
#  @   # * # 
#    #######    
#      !   #
#          #
############