##########
#!       #
#    @   #
#        #
#     #@ #  
# @   # *# 
#   ######    
#   ! #### 
#!    #### 
###########