#########
#  #### #
#  #@ # #
####$$###
##    .##
##   $ ##
###. ####
# #. #  #
# ####  #
#########