.  ####   
     ##   
  @ .#    
###      #
#   # #   
# #   ### 
#  #  ### 
##     #  
#  #$   $ 
#     #   