############
#      #####
#  # #     #
####   ### #
#  ####   .#
#  #  # $ .#
#  #$ @##  #
# ##   ### #
#       # $#
#          #
#       . ##
############